10
A.-.-.-.-.G.S.W.GS.-
-.-.-.-.G.-.-.BS.-.-
G.-.-.G.-.G.B.P.B.-
-.-.-.-.-.-.-.BG.-.B
-.-.-.-.G.-.G.-.B.PS
G.-.G.-.-.-.G.G.S.BW
-.B.-.G.-.-.-.-.-.GS
B.P.B.-.-.-.-.-.-.-
P.BG.-.-.-.G.-.-.G.-
BG.P.B.-.-.-.-.-.-.G
